BIRRRRRRRWRRRRRRRRRRWRRRRWRRRR
WWRWWRRRRWRRRCRRRRRRWRCRWWWRRR
RRRRWRRRRWRWWWWPOWWRRWRRRRWRRKDR
RWRRWRRRRWRWGGGGGWRRWRWRRWRRWR
WWWWWWRRRPORWGGGGGWRRPORWWWWWWWR
RWRRWRRMRWWWGGGGGWRRWRWRRWRRWR
RRRRWRRRCRRWGGGGGWRRWRRRRWRRRR
RCWWWWRRRRRWWWWWWWRRWRRRWWWRRR
RRWRRRRRRRRWRRRRRRRRWRRRRRWRRR
RRWWPRWWWWWWWWWWWPOWWWWWWWWPRWRRR
RRRRRRRRRWRRRRWRRRRRWRRRRRRRRR
RRWRRRRRRWRRRRWRRRRRWRRCRRWWRR
RRWWRWWRRWRWRRWRRRRRWRWWRRRWRR
RRWWRWWRRWRWWWWRRWRRWRWWRRRWWR
RRWWRWWMRWRWRRWWWWRRRRRRRRWWRR
RRRRCRWRRRRRRRWRRRRRWRRRRRKRWRR
RRWWRWWRRWRRRRWRWWRRWWWWWWWWRR
RRWWRWWRRWRRRWWRWWRRWRWRRWRRRR
RWWWRWWRRWRRRRRRRRRRRRWRRRRRRR
RRRRRRRRRWRRRRRRRRRRRRWRRRRRRR
WRRRWWPGWWWRRWWPGWWWRRWWWWWPGWWWW
WWRRWRRRRWRRWRRRRWRRWRRRRRRRRR
WRRRWRCRRWRRWRRRRWRRWRRRRRRRMR
WRRWWRRRRWWWWWWRWWWRWRRRRRWRRR
WRRRWRRRRRRRRRWRRRWWWWWWWWWRRR
WWRRWRRRRWRRRRRRRRRRWRRWRRCRRR
WWWWWWRRRWRRWWRRRRRRWRRRRRWWRR
KGRRRRRRRRWRRWRRRRRGRRRRRRRRWRR
RRRRWWRRRWRRWRRRRRRRWRWWWRRWRR
RRRRWWRRRWRRWRERRKDBRWRWWWRRWRR
