DRRRRRRRRWRRRRRRRRRRWRRRRWRRRR
WWRWWRRRRWRRRBRRRRRRWRBRWWWRRR
RRRRWRRRRWRWWWWPOWWRRWRRRRWRRKDR
RWRRWRRRRWRWGGGGGWRRWRWRLWRRWR
WWWWWWRRRPORWGGGGGWRRPORWWWWWWWR
RWRLWRRMRWWWGGGGGWRRWRWRRWRRWR
RRRRWRRRBRRWGGGGGWRRWRRRRWRRRR
RBWWWWRRRRRWWWWWWWRRWRRRWWWRRR
RRWRRRRRRRRWRRRRRRRRWRRRRRWRRR
RRWWPRWWWWWWWWWWWPOWWWWWWWWPRWRRR
RRRRRRRRRWRRRRWRRRRRWLRRRRRRRR
RRWRRRRRRWRRRRWRRRRRWRRBRRWWRR
RRWWRWWRRWRWRRWRRRRRWRWWRRRWRR
RRWWRWWRRWRWWWWRRWRRWRWWRRRWWR
RRWWRWWMRWRWRRWWWWRRRRRRRRWWRR
RRRRBRWRRRRRRRWLRRRRWRRRRRKRWRR
RRWWRWWRRWRRRRWRWWRRWWWWWWWWRR
RRWWRWWRRWRRRWWRWWRRWRWRRWRRRR
RWWWRWWRRWRRRRRRRRRRRRWRRRRRRR
RRRRRRRRRWRRRRRRRRRRRRWRRRRRRR
WRRRWWPVWWWRRWWPVWWWRRWWWWWPVWWWW
WWRRWRRRRWRRWRRRRWRRWRRRRRRRRR
WRRRWRBRRWRRWRRRRWRRWRRRRRRRMR
WRRWWRRRRWWWWWWRWWWRWRRRRRWRRR
WRRRWRRRRRRRRRWRRRWWWWWWWWWRRR
WWRRWRRRRWRRRRRRRRRRWRRWRRBRRR
WWWWWWRRRWRRWWRRRRRRWRRRRRWWRR
KVRRRRRRRRWRRWRRRRIRRRRRRRRRWRR
RRRRWWRRRWRRWRRRRRRRWRWWWRRWRR
RRRRWWRRRWRRWRERRRRRWRWWWRRWRR
