DRRRRRRRRWRRRRRRRRRRWRRRRWRRRR
WWRWWRRRRWRRRBRRRRRRWRBRWWWRRR
RRRRWRRRRWRWWWWPOWWRRWRRRRWRRKDR
RWRRWRRRRWRWGGGGGWRRWRWRRWRRWR
WWWWWWRRRPORWGGGGGWRRPORWWWWWWWR
RWRRWRRMRWWWGGGGGWRRWRWRRWRRWR
RRRRWRRRBRRWGGGGGWRRWRRRRWRRRR
RBWWWWRRRRRWWWWWWWRRWRRRWWWRRR
RRWRRRRRRRRWRRRRRRRRWRRRRRWRRR
RRWWPRWWWWWWWWWWWPOWWWWWWWWPRWRRR
RRRRRRRRRWRRRRWRRRRRWRRRRRRRRR
RRWRRRRRRWRRRRWRRRRRWRRBRRWWRR
RRWWRWWRRWRWRRWRRRRRWRWWRRRWRR
RRWWRWWRRWRWWWWRRWRRWRWWRRRWWR
RRWWRWWMRWRWRRWWWWRRRRRRRRWWRR
RRRRBRWRRRRRRRWRRRRRWRRRRRKRWRR
RRWWRWWRRWRRRRWRWWRRWWWWWWWWRR
RRWWRWWRRWRRRWWRWWRRWRWRRWRRRR
RWWWRWWRRWRRRRRRRRRRRRWRRRRRRR
RRRRRRRRRWRRRRRRRRRRRRWRRRRRRR
WRRRWWPVWWWRRWWPVWWWRRWWWWWPVWWWW
WWRRWRRRRWRRWRRRRWRRWRRRRRRRRR
WRRRWRBRRWRRWRRRRWRRWRRRRRRRMR
WRRWWRRRRWWWWWWRWWWRWRRRRRWRRR
WRRRWRRRRRRRRRWRRRWWWWWWWWWRRR
WWRRWRRRRWRRRRRRRRRRWRRWRRBRRR
WWWWWWRRRWRRWWRRRRRRWRRRRRWWRR
KVRRRRRRRRWRRWRRRRIRRRRRRRRRWRR
RRRRWWRRRWRRWRLRRRRRWRWWWRRWRR
RRRRWWRRRWRRWRERRRRRWRWWWRRWRR
